111111111
1P0010011
100010011
101000011
101000011
111111111