11111111111111111
1P001001111111111
10001001111111111
10100000000000001
10100000000000001
10000000000000001
10000000000000001
10000000000000001
10000000000000001
10000000000000001
10000000000000E01
11111111111111111