11111111
1P001001
10001001
10100001
10100001
11111111