111111111111
1P00000000001
100000000C001
100000C00C001
10000000C0001
10000000000E1
1111111111111